++++++++++++++++++++++
+ + ++ ++     ++++++++
+ +++++++ +++ ++++++++
+ + +      ++  +++++++
+ + + + ++ +++ + +++++
+ ++  + + +    +    ++
+++++ + + ++ +   ++  -
+++++ +++ + ++++ +++++
+ + + S+ + + +    ++++
+++++ + + + + + + ++++
++++++++++++++++++++++